-1,102,102,102,102,102,102,102,102,102,102
202,0,0,0,0,0,0,0,0,0,0
202,0,0,0,0,0,0,0,0,0,0
202,0,0,0,0,0,0,0,0,0,0
202,0,0,0,0,0,0,0,0,0,0
202,0,2,3,0,0,0,0,0,0,0
202,0,4,1,0,0,0,0,0,0,0
202,0,0,0,0,0,1,0,0,0,0