-1,-1,102,102,102,102,102,102,102,102,102,102,-1,-1
-1,-1,102,102,102,102,102,102,102,102,102,102,-1,-1
202,202,0,0,0,0,0,0,0,0,0,0,302,302
202,202,0,0,0,0,0,0,0,0,0,0,302,302
202,202,0,0,0,0,0,0,0,0,0,0,302,302
202,202,0,0,0,0,0,0,0,0,0,0,302,302
202,202,0,0,0,0,0,0,0,0,0,0,302,302
202,202,0,0,0,0,0,0,0,0,0,0,302,302
202,202,0,0,0,0,0,0,0,0,0,0,302,302
202,202,0,0,0,0,1,0,0,0,0,0,302,302